(train)ticket: runi
-by-way-of: tashi
-diminutive: shi
-er: bo
-full: bi
-ify: wa
-less: gar
-ly: ra
-ness: syu
-ongoing-habitual: toi
-possessive: hei
0: ke
100: kyo
10: zyu
1: ki
1e3: me
1e4: re
2: sa
3: de
4: to
5: do
6: hi
7: no
8: te
9: gi
ACC: u
April: ishi
August: zisyu
DAT: i
December: azi
Earth: noma
FUT: mo
FUTFUT: momo
FUTFUTPROG: moonku
FUTPAST: moru
FUTPASTPROG: moruku
FUTPROG: moku
Fall-Winter: iki
February: mata
Friday: mode
GEN: o
God: sun
January: iru
Job: sobu
July: yoryo
June: gade
March: nopa
May: rui
Monday: ido
NEG: r
November: rua
October: derya
PAST: ru
PASTFUT: rumo
PASTFUTPROG: rumoku
PASTPAST: ruru
PASTPASTPROG: ruruku
PASTPROG: ruku
PLUR1st: kang
PLUR2nd: dun
PLUR3rd: han
PLURAL: n
POSSESSIVE: shi
PRESPROG: ku
SING1st: ka
SING2nd: du
SING3rd: ha
Saturday: isyu
September: moi
Society: dei
Spring-Summer: zuku
Sunday: suta
T-shirt: yonto
Thursday: sei
Tuesday: ide
Wednesday: aru
above: un
actor: tazyo
adjective: rui
adult: unga
aether-mechanics: sesete
aether: se
afternoon: koyo
air: dona
aircraft: moka
airport: mokake
and: wa
anguished: iha
animal: rau
ant: tei
apart: kya
apartment: ike
apologize: rakani
apple: tsuru
arm: niro
army: mon
around-circular: rushi
art: tatakyo
artist: uri
ask: tsuu
at-back: nisupe
at-front: gin
at: to
attack: ruu
author: hasyu
awaken: toru
away: ban
baby: gaa
back: kuki
backward: dono
bad: kano
bag: son
ball: meha
banana: meka
band: shika
bank: tano
bar: ruka
barn: tyokike
bat: ina
bathroom: uru
beach: rina
beard: muya
beat: borya
beautiful: rusa
bed: kuba
bedroom: kukuru
beef: ini
beer: tsuru
beetle: bureto
before-or-behind: ronon
below: kan
bend: suoha
beside: neune
beverage: hitsu
bicycle: hini
bill: uko
bird: suno
black: kure
blind: iro
blood: shisu
bludgeon: shioyo
blue: syui
boat: hetsu
body: muyo
bone: ino
book: oru
bottle: keyo
bottom: tsuku
box: mipiru
boy: ute
brain: kiki
bread: ana
break: umi
breakfast: deki
bridge: teufu
brother: kiru
brown: tada
build: zuse
building: iga
burn: sakasyo
bus: yota
but: syu
buy: kote
cake: dema
call: kichi
camera: iki
camp: yashi
can: po
car: kama
card: utsu
carry: seme
cat: uka
catch: tatyokyo
cattle: seu
ceiling: kage
centimeter: kui
chair: ota
cheap: nose
cheese: usu
chicken: niya
child: sa
church: rui
circle: noi
circumstance: shiki
city: rau
clay: kosa
clean: tsuni
clock: kin
close-friend: zihabi
close: utyushi
clothing: tyo
club: usyoki
coat: rate
coffee: tyote
cold: too
collapse: gyobo
color: ne
computer: nara
consonant: kyude
contract: kauyo
cook: dori
cool: nou
copper: dena
corn: ho
corner: hahi
could: ra
count: itsu
country: tee
court: damesa
cow: tyoki
crowd: kechi
cry: go
crystal: in
cup: rusa
curved: in
cut: ito
dance: sur
dark: uda
darkness: udasyu
date: shino
daughter: raha
day: de
dead: nyuto
deaf: noyu
death: ta
deep: chizi
depressed: bipa
diamond: tsushi
die: naha
dig: gai
dinner: zino
direction: naki
dirty: zyuto
disease: mun
do: shi
doctor: yota
dog: zyou
dollar: oge
door: uko
dot: shisu
down: utake
dragon: noru
draw: tanni
dream: tsun
dress: ino
drink: isau
drive: ika
drug: riki
dry: hao
dust: imi
ear: uge
east: ugu
eat: urimamo
edge: syuto
egg: fur
election: zyoi
electronics: ruka
elemental: shinoroi
enchant: kyoko
energy: ma
engine: gashi
enough: igu
ethnicity: utsu
evening: nosyo
excuse-me: shiga
exercise: mima
exoskeleton: inogyanor
expensive: tane
explode: in
eye: bai
face: nitsu
fail: bita
fall: reko
family: rutsu
famous: noi
fan: na
farm: chin
fast: daka
father: hanka
feed: koi
female: kau
fight: gyo
fill: kedo
find: rui
finger: sua
fire: kike
fish: kita
flat: sene
floor: ruu
flower: sozyuku
fly: soe
follow: eyu
food: kin
foot: rikuhi
forest: kuso
forget: nosa
forgive: rudo
fork: ton
forward: hahi
fraction-ending(-st-nd-rd-th): ri
friend: zi
front: kese
game: hate
garden: syote
gasoline: iri
gift: zehi
girl: on
glass: busui
go: ryo
gold: uha
good: kishise
goodbye: ba
grandfather: nan
grandmother: oka
grass: shigo
gray: ton
green: tosa
greetings: shibe
grief: shiro
ground: susyu
grow: uto
gun: isa
hair: uru
half: heki
hand: haru
hang: yare
happy: in
hard: uta
hat: ruu
hate: muto
have-sex: gan
have: he
head: utsuda
healthy: utsu
hear: kuru
heart: zyan
heat: suchi
heaven: name
heavy: usyosu
hell: syo
hello: ki
here: fu
high: osa
hill: nono
hole: gafu
home: kika
hope-noun: ge
hope-verb: gehe
horse: natsuchi
hospital: sai
hot: aru
hotel: rueke
hour: ma
house: ke
however: bu
human: tamasa
husband: utsu
ice: nide
if: ure
iff: yure
image: haro
impale: tsuki
importance: iza
inch: haka
injury: toru
insect: moo
inside-of: rara
inside: niza
is: su
island: itado
joy: pau
joyful: moka
juice: osyo
jump: kuge
key: ema
kick: noho
kicker: nohoroi
kill: nata
kilogram: toya
king: zihe
kiss: eto
kitchen: ido
knee: koi
knife: yosyu
lake: niho
lamp: wayu
large: nanzi
laugh: rinida
launch: ota
lawyer: bia
leaf: rui
learn: ude
left: koku
leg: uyu
lemon: uka
letter: igo
library: ano
liedown: kikuri
life: bi
lift: syoi
light-weight: gano
light: umaga
lip: edomi
listen: uryo
live: guha
living: shino
location: mai
lock: shika
long: in
look-at: hoito
loose: hai
lose: yofu
loud: bano
love-verb: tsunan
love: tsu
low: nina
lunch: toziko
magazine: subu
male: sareki
man: tsu
manager: yon
mankind: zite
map: kore
market: soki
marriage: mishiki
marry: mi
material: shikyo
matter: to
may: zyo
mean: susyoe
meaning: ubu
measurement: tari
mechanics-workings: sete
medicine: iha
melt: ruso
metal: ine
meter: raha
might: gu
milk: man
minute: ga
miss-verb: ze
mix/stir: noo
money: ani
month: mere
moon: kai
morning: zimo
mother: idemo
mountain: kasu
mouse: miha
mouth: doga
mud: shihi
murder: uhi
music: suno
musical-instrument: rii
must: nohe
narrow: ino
nature: noza
neck: rurei
need: seku
needle: oruke
neighbor: toter
network: uketo
new: shiki
newspaper: umu
nice: souma
night: yo
no: syo
noontime: rune
north: yaka
nose: fuzyo
note: rita
noun: uro
nuclear: tazya
number: netsu
ocean: tsuru
office: nimo
oil: tou
old-age: esu
old-time: okya
on-the-left: funo
on-the-right: mushi
open: take
or: pa
orange: ninowa
ore: nora
outside-of: koo
outside: nuno
owl: zyoimo
page: zese
pain: ina
paint: chichi
paintbrush: noho
pants: ropo
paper: ruta
parent: toni
park: nishi
pass: iko
patient: koa
pattern: iku
pay: urise
peace: yoo
pen: haonoho
pencil: on
person: zi
phoenix: kikesuno
phone: nono
photograph: ruko
piece: run
pig: ryaki
pine-after: daunan
pink: soshi
plant: sechi
plastic: gete
plate: mesu
play: syudaga
player: uya
pocket: syoida
poison: moo
police: soi
pond: daku
pool: chichio
poor: kuru
pork: sudato
pound: boryo
pray: tou
president: basyo
price: nigi
priest: tyu
prison: rubu
program: sata
puddle: wahityo
pull: iyata
punch: rudo
push: in
queen: sor
quiet: kai
race(sport): umiha
radio: hini
rain: kunita
re-: chi
red: tosa
relationship-romantic: sosa
religion: kan
remember: so
reporter: rute
restaurant: un
rice: ichi
rich: tau
right: ire
ring: man
river: in
roof: kuita
room: runo
root: uda
run: hahi
sad: eru
sadness: erusyu
salt: nazi
sand: tyuto
say: mono
school: sui
science: isui
screen: yani
sea: shin
season: iga
second: ni
secretary: nichie
see: hoi
seed: uru
sell: on
seperate: ribe
sex-act: gangaru
sex-gender: rusyo
shake: ifu
shall: yu
shallow: kii
share: zisa
ship: nokyo
shirt: nou
shoes: kao
shoot-at: zipunan
shoot: zipu
short-height: gisa
short-length: tato
should: mu
shoulder: nisagaka
show: hamo
sick: shiha
side: oku
sign: nano
silver: tosa
sing: nina
sir-ma'am: no
sister: gana
sit: hika
skin: gyanor
skirt: kon
sky: nyuo
sleep: tan
slice: henika
slightly: ya
slow: niya
small: gite
smell: sya
smile: ona
snow: tyo
soap: dase
soft: ara
soil: zya
soldier: usa
son: uku
song: ita
sorrow: kuta
sorry: hakyu
sound: ruu
soup: gisya
south: tsukao
space: iku
spider: matyu
spoon: suki
sport: omo
spring: man
square: gaku
stable: natsuchike
stain: gaa
stand: geu
star: iki
steel: iru
stone: roi
stop: nate
store/shop: kato
straight: gosyo
street: noi
strong: ro
student: zitsu
sugar: gagi
suit: dakuu
sun: nede
sweat: kae
swim: nada
table: tai
tall: uka
taste: ar
tea: rara
teach: kesa
teacher: chizo
team: omota
teardrop: dode
technology: karu
telephone: tsuka
television: gamo
temperature: uka
thanks: uru
that-those: ra
theater: miga
there: da
therefore: da
thick: tana
thin: mino
think: kura
this-these: zyo
throw: seru
tight: bun
time: yuda
tire: keha
to(towards-ending-at): ruki
toe: kawa
together: ze
tongue: ime
tool: kukishi
tooth: ziki
top: shigyo
touch: toba
towards: nan
town: ko
train: naya
trainstation: nayake
transportation: ishi
travel: kuna
traveler: rue
tree: iki
truck: neshi
turn: tsuta
type-kind: te
ugly: teo
un-: ta
university: hiu
up: hai
valley: noyo
value: zu
verb: bui
very: habi
victim: ote
voice: ita
vowel: kuzoni
waiter: umu
walk: risa
wall: oho
want: dau
war: kime
warm: reme
wash: izyu
watch: tekai
water: syotyoru
wave: saka
weak: beka
wear: ruse
wedding: mide
week: niko
weight: uru
welcome-here: kika
west: sura
wet: osya
while: kone
white: ten
wide: eku
wife: nishi
win: un
wind: iro
window: chihyo
wine: toshi
wing: tsusu
with: garu
woman: ma
wood: hon
work: ruu
world: boto
write: naha
xor: fu
yard: tsuo
year: nauda
yearning: usa
yellow: ryoru
yes: haku
yet-moment: yu
you're-welcome: touto
young: u